1234
XXXXXXXXXUUXXXXXXXXX
XP................PX
X..................X
X..................X
X..................X
L..................R
L..................R
X..................X
X..................X
X..................X
XP................PX
XXXXXXXXXDDXXXXXXXXX