
XXXXXXXXXUUXXXXXXXXX
XX.PXXXXXUUXXXXXP.XX
X....XXXXXUUXXXX...X
XX................XX
XX................XX
L..................R
L..................R
XX................XX
XX................xX
X....XXXXDDXXXX....X
XX.PXXXXXDDXXXXXP.XX
XXXXXXXXXDDXXXXXXXXX