
XXXXXXXXXUUXXXXXXXXX
XP.....XXUUXXXXXXXXX
X......XXUUXXXXXXXXX
XXX.....P......XXXXX
XXX...XXX........XXX
L.....XXX.........PR
LP.........XXX.....R
XXX........XXX...XXX
XXXXX......P.....XXX
XXXXXXXXXDDXX......X
XXXXXXXXXDDXX.....PX
XXXXXXXXXDDXXXXXXXXX