
XXXXXXXXXUUXXXXXXXXX
XXXX............XXXX
XXXX............XXXX
XXXX.......XXP..XXXX
XXXX.......XXX..XXXX
LLLL.......XXX..RRRR
LLLL..XXX.......RRRR
XXXX..XXX.......XXXX
XXXX..PXX.......XXXX
XXXX............XXXX
XXXX............XXXX
XXXXXXXXXDDXXXXXXXXX