1234
XXXXXXXXX..XXXXXXXXX
XP................PX
X..................X
X..................X
X.......XXXX.......X
........XXXX........
........XXXX........
X.......XXXX.......X
X..................X
X..................X
XP................PX
XXXXXXXXX..XXXXXXXXX