1234
XXXXXXXXXUUXXXXXXXXX
XXXXXXXXXUUXXXXXXXXX
XP......XUUX.......X
X.......XUUX.......X
X...........XX.....X
L...........XX.....R
L...........XX.....R
X...........XX.....X
X.......XDDXXX.....X
XP......XDDXXX....PX
XXXXXXXXXDDXXXXXXXXX
XXXXXXXXXDDXXXXXXXXX