
XXXXXXXXXUUXXXXXXXXX
XXXX............XXXX
XXXX............XXXX
XXXX...XP..PX...XXXX
XXXX...XX..XX...XXXX
LLLL............RRRR
LLLL............RRRR
XXXX...XX..XX...XXXX
XXXX...XP..PX...XXXX
XXXX............XXXX
XXXX............XXXX
XXXXXXXXXDDXXXXXXXXX