XXXXXXXXX..XXXXXXXXX
XP................PX
X..................X
X..................X
X..................X
....................
....................
X..................X
X..................X
X..................X
XP................PX
XXXXXXXXX..XXXXXXXXX