24
XXXXXXXXX..XXXXXXXXX
XXXXXXXXX..XXXXXXXXX
XXXXXP.........XXXXX
XXXXX..........XXXXX
XXXXX..........XXXXX
XXXXX..........XXXXX
XXXXX..........XXXXX
XXXXX..........XXXXX
XXXXX..........XXXXX
XXXXX.........PXXXXX
XXXXXXXXX..XXXXXXXXX
XXXXXXXXX..XXXXXXXXX