
XXXXXXXXXUUXXXXXXXXX
XP.......UU.......PX
X..................X
X..................X
X..................X
LL................RR
LL................RR
X..................X
X..................X
X..................X
XP.......DD.......PX
XXXXXXXXXDDXXXXXXXXX