
XXXXXXXXXUUXXXXXXXXX
XXXXXXXXXUUXXXXXXXXX
XP................PX
X..................X
X........XX........X
L......XXXXXX......R
L......XXXXXX......R
X........XX........X
X..................X
XP................PX
XXXXXXXXXDDXXXXXXXXX
XXXXXXXXXDDXXXXXXXXX