1234
XXXXXXXXXUUXXXXXXXXX
XXXXXXXXXUUXXXXXXXXX
X..................X
X..................X
X..................X
L..................R
L..................R
X..................X
X..................X
X..................X
XXXXXXXXXDDXXXXXXXXX
XXXXXXXXXDDXXXXXXXXX