
XXXXXXXXXUUXXXXXXXXX
XXXXXXX.PUUP.XXXXXXX
XXXX............XXXX
XXX..............XXX
XXXP............PXXX
LLLL............RRRR
LLLL............RRRR
XXXP............PXXX
XXX..............XXX
XXXX............XXXX
XXXXXXX.PDDP.XXXXXXX
XXXXXXXXXDDXXXXXXXXX