
XXXXXXXXXUUXXXXXXXXX
XP................PX
X..................X
XXXXXXXX....XXXXXXXX
XXXXXXXX....XXXXXXXX
L..................R
L..................R
XXXXXXXX....XXXXXXXX
XXXXXXXX....XXXXXXXX
X..................X
XP................PX
XXXXXXXXXDDXXXXXXXXX