
XXXXXXXXXUUXXXXXXXXX
XX.PXXXXXUUXXXXXP.XX
X...XXXXXUUXXXXX...X
XX................XX
XX................XX
L..................R
L..................R
XX................XX
XX................xX
X...XXXXXDDXXXXX...X
XX.PXXXXXDDXXXXXP.XX
XXXXXXXXXDDXXXXXXXXX