13
XXXXXXXXXUUXXXXXXXXX
XP...PXXP.........PX
X.....XX...........X
X.....XX...........X
X..................X
L..................R
L..................R
X..................X
X...........XX.....X
X...........XX.....X
XP.........PXXP...PX
XXXXXXXXXDDXXXXXXXXX