
XXXXXXXXXUUXXXXXXXXX
XXXXXXX.PUUP.XXXXXXX
XXXX............XXXX
XXXX............XXXX
XXXX............XXXX
LLLL............RRRR
LLLL............RRRR
XXXX............XXXX
XXXX............XXXX
XXXX............XXXX
XXXXXXX.PDDP.XXXXXXX
XXXXXXXXXDDXXXXXXXXX