13
XXXXXXXXXUUXXXXXXXXX
XP..PXXXP.........PX
X....XXX...........X
X....XXX...........X
X....XXX....XXX....X
L....XXX....XXX....R
L....XXX....XXX....R
X....XXX....XXX....X
X...........XXX....X
X...........XXX....X
XP.........PXXXP..PX
XXXXXXXXXDDXXXXXXXXX