
XXXXXXXXXUUXXXXXXXXX
XPXXPXXPUUUUPXXPXXPX
X..................X
X..................X
X..................X
L..................R
L..................R
X..................X
X..................X
X..................X
XPXXPXXPDDDDPXXPXXPX
XXXXXXXXXDDXXXXXXXXX