24
XXXXXXXXXUUXXXXXXXXX
XXXXXXXXXUUXXXXXXXXX
XXXXXP.........XXXXX
XXXXX..........XXXXX
XXXXX..........XXXXX
LLLLL..........RRRRR
LLLLL..........RRRRR
XXXXX..........XXXXX
XXXXX..........XXXXX
XXXXX.........PXXXXX
XXXXXXXXXDDXXXXXXXXX
XXXXXXXXXDDXXXXXXXXX