1234
XXXXXXXXXUUXXXXXXXXX
XP................PX
X..................X
X..................X
X.......XXXX.......X
L.......XXXX.......R
L.......XXXX.......R
X.......XXXX.......X
X..................X
X..................X
XP................PX
XXXXXXXXXDDXXXXXXXXX