
XXXXXXXXXUUXXXXXXXXX
XXX.............PXXX
XX................XX
XX.......XX.......XX
XX......PXXP......XX
LL.....XXXXXX.....RR
LL.....XXXXXX.....RR
XX......PXXP......XX
XX.......XX.......XX
XX................XX
XXXP.............XXX
XXXXXXXXXDDXXXXXXXXX