
XXXXXXXXXUUXXXXXXXXX
X..PXXXXXUUXXXXXP..X
X...XXXXXUUXXXXX...X
X..................X
X..................X
L..................R
L..................R
X..................X
X..................X
X...XXXXXDDXXXXX...X
X..PXXXXXDDXXXXXP..X
XXXXXXXXXDDXXXXXXXXX