
XXXXXXXXXUUXXXXXXXXX
XX.......UU.......XX
X..................X
XP................PX
X..................X
LL.......XX.......RR
LL.......XX.......RR
X..................X
XP................PX
X..................X
XX.......DD.......XX
XXXXXXXXXDDXXXXXXXXX