1234
XXXXXXXXXUUXXXXXXXXX
XXXXXXXXXUUXXXXXXXXX
XP.................X
X..................X
X...........XX.....X
L...........XX.....R
L...........XX.....R
X...........XX.....X
X...........XX.....X
XP..........XX....PX
XXXXXXXXXDDXXXXXXXXX
XXXXXXXXXDDXXXXXXXXX