
XXXXXXXXXUUXXXXXXXXX
XX.PXXXXXUUXXXXXXXXX
X...XXXXXUUXXXXXXXXX
XX................PX
XX.................X
L..................R
L..................R
X.................XX
XP................XX
XXXXXXXXXDDXXXXX...X
XXXXXXXXXDDXXXXXP.XX
XXXXXXXXXDDXXXXXXXXX