
XXXXXXXXXUUXXXXXXXXX
XXXXXXXXXUUXXXXXXXXX
XP..XX........XX..PX
X..................X
X..................X
L..................R
L..................R
X..................X
X..................X
XP..XX........XX..PX
XXXXXXXXXDDXXXXXXXXX
XXXXXXXXXDDXXXXXXXXX