
XXXXXXXXXUUXXXXXXXXX
X..PXXXXXUUXXXXXXXXX
X...XXXXXUUXXXXXXXXX
X..................X
X..................X
L..................R
L..................R
X..................X
X..................X
XXXXXXXXXDDXXXXX...X
XXXXXXXXXDDXXXXXP..X
XXXXXXXXXDDXXXXXXXXX