
XXXXXXXXXUUXXXXXXXXX
XXXX.P.XXUUXX.P.XXXX
X..................X
X..................X
X..................X
L..................R
L..................R
X..................X
X..................X
X..................X
XXXX.P.XXDDXX.P.XXXX
XXXXXXXXXDDXXXXXXXXX