
XXXXXXXXXUUXXXXXXXXX
XXXXXXXXXUUXXXXXXXXX
XP................PX
X..................X
X..................X
L....XXXX..XXXX....R
L....XXXX..XXXX....R
X..................X
X..................X
XP................PX
XXXXXXXXXDDXXXXXXXXX
XXXXXXXXXDDXXXXXXXXX