1234
XXXXXXXXXUUXXXXXXXXX
XXXXXXXXXUUXXXXXXXXX
X..................X
X..................X
X..................X
L...........XX.....R
L...........XX.....R
X...........XX.....X
X...........XX.....X
X...........XX.....X
XXXXXXXXXDDXXXXXXXXX
XXXXXXXXXDDXXXXXXXXX