1234
XXXXXXXXXUUXXXXXXXXX
XXXXXXXXXUUXXXXXXXXX
XP.......UU.......PX
X........UU........X
X..................X
L..................R
L..................R
X..................X
X........DD........X
XP.......DD.......PX
XXXXXXXXXDDXXXXXXXXX
XXXXXXXXXDDXXXXXXXXX