
XXXXXXXXXUUXXXXXXXXX
XX.PXXXXXUUXXXXXXXXX
X....XXXXUUXXXXXXXXX
XX................PX
XX.................X
L..................R
L..................R
X.................XX
XP................XX
XXXXXXXXXDDXXXX....X
XXXXXXXXXDDXXXXXP.XX
XXXXXXXXXDDXXXXXXXXX