
XXXXXXXXXUUXXXXXXXXX
XP.....XXUUXXXXXXXXX
X......XXUUXXXXXXXXX
XXX.....P......XXXXX
XXX...XXX........XXX
L.....XXX..........R
L..........XXX.....R
XXX........XXX...XXX
XXXXX......P.....XXX
XXXXXXXXXDDXX......X
XPXXXXXXXDDXXXXXXXPX
XXXXXXXXXDDXXXXXXXXX