
XXXXXXXXXUUXXXXXXXXX
XXXXXXXXXUUXXXXXXXXX
XXXX............XXXX
XXX..............XXX
XXXP............PXXX
LLLL............RRRR
LLLL............RRRR
XXXP............PXXX
XXX..............XXX
XXXX............XXXX
XXXXXXXXXDDXXXXXXXXX
XXXXXXXXXDDXXXXXXXXX