24
XXXXXXXXXUUXXXXXXXXX
XXXXXXXXXUUXXXXXXXXX
XXXXXP........XXXXXX
XXXXX..........XXXXX
XXXXX..........XXXXX
LLLLL..........RRRRR
LLLLL..........RRRRR
XXXXX..........XXXXX
XXXXX..........XXXXX
XXXXXX........PXXXXX
XXXXXXXXXDDXXXXXXXXX
XXXXXXXXXDDXXXXXXXXX