1234
XXXXXXXXXUUXXXXXXXXX
XXXXXXXXXUUXXXXXXXXX
XXXXXXXXXUUXXXXXXXXX
XXXXXXX......XXXXXXX
XXXXXXX......XXXXXXX
LLLLLLL......RRRRRRR
LLLLLLL......RRRRRRR
XXXXXXX......XXXXXXX
XXXXXXX......XXXXXXX
XXXXXXXXXDDXXXXXXXXX
XXXXXXXXXDDXXXXXXXXX
XXXXXXXXXDDXXXXXXXXX